#################      ################# 
#################                      #
#########       #######                #
####                  ######           #      
####                       ############# 
###                                    # 
##                                     # 
##                                     # 
##                                     # 
##                                     # 
                                       # 
                                       
    
   
   
   
#                                      #   
#                                      #   
#   ::::    ::::::::         ::::::::::#   
#::::::::  :::::::::::::    :::::::::::#   
#::::::::::::::::::::::::::::::::::::::#   
#::::::::::::::::::::::::::::::::::::::#   
#::::=======:::::::::::::::::::::::::::#  
#::==================:::::::::=========#    
#======================================# 
#======================================# 
#======================================# 
######################################## 
