#################      #################
######         ##                      #
######          ##                     #
######           #########             # 
#####                    ###############
####                                  ##
####                                  ##
####                                  ##
####                                  ## 
###                                   ##






####                                  ##
#####                                 ##
#####                                ###
#####                                ### 
#####                                ###
#####                                ###
######                               ###
#########                            ###
##########                          ####
###########                #############
#################      #################
#################      #################
