#################      ################# 
#           ##            ##           #
#            ##          ##            #
#             ############             #
#                                      #
#                                      #
#                                      #
#                                      #
#                                      #
#                                      #
#                                      # 
                                       #
                                       #
                                       #
                                       #
                                       #
#                                      #
#                                      #
#                                      #
#                                      #
#            #####                     #
#          ###   ########              #
#       ####            ###            #
#########                 ####         #
#                            #####     #
#                                #######
#                                      #
########################################
