#################      ################# 
#           ##            ##           #
#            ##          ##            #
#             ############             #
#                                      #
#                                      #
#                                      #
#                                      #
#                                      #
#                                      #
                                       # 
                                       #
                                       #
                                       #
                                       #
                                       #
#                                      #
#                                      #
#:::::::   ::::::::::::::::::        ::#
#:::::::::::::::::::::::::::::     ::::#
#::::::::::::=====:::::::::::::::::::::#
#::::::::::==============::::::::::::::#
#:::::::===================::::::::::::#
#=============================:::::::::#
#=================================:::::#
#======================================#
#======================================#
########################################
