#################      ################# 
#            #            #            #
#             #          #             #
#              ##########              #
#                                      #
#                                      #
#                                      #
#                                      #
#                                      #
#                                      #
#                                      #
#                                      #
#                                      #
#                                      #
#                                      #
#                                      #
#                                      #
#                                      #
#                                      #
#####                                  #
#    #        ###                      #
#     #     ##   ########              #
#      #####             ##            #
#                          ###         #
#                             ###      #
#                                #######
#                                      #
########################################
