#################cccccc################# 
#GGGGGGGGGGG##cccccccccccc##GGGGGGGGGGG#
#GGGGGGGGGGGG##cccccccccc##GGGGGGGGGGGG#
#GGGGGGGGGGGGG############GGGGGGGGGGGGG#
#GGGGGGGGGGGGGGGGGGGGGGGGGGGGGGGGGGGGGG#
RRGGGGGGGGGGGGGGGGGGGGGGGGGGGGGGGGGGGGG#
RRRRGGGGGGGGGGGGGGGGGGGGGGGGGGGGGGGGGGG#
RRRRGGGGGGGGGGGGGGGGGGGGGGGGGGGGGGGGGGG#
RRRGGGGGGGGGGGGGGGGGGGGGGGGGGGGGGGGGGGG#
RRGGGGGGGGGGGGGGGGGGGGGGGGGGGGGGGGGGGGG#
RGGGGGGGGGGGGGGGGGGGGGGGGGGGGGGGGGGGGGG# 
GGGGGGGGGGGGGGGGGGGGGGGGGGGGGGGGGGGGGGG#
GGGGGGGGGGGGGGGGGGGGGGGGGGGGGGGGGGGGGGG#
GGGGGGGGGGGGGGGGGGGGGGGGGGGGGGGGGGGGGGG#
GGGGGGGGGGGGGGGGGGGGGGGGGGGGGGGGGGGGGGG#
GGGGGGGGGGGGGGGGGGGGGGGGGGGGGGGGGGGGGGG#
GGGGGGGGGGGGGGGGGGGGGGGGGGGGGGGGGGGGGGG#
RRGGGGGGGGGGGGGGGGGGGGGGGGGGGGGGGGGGGGG#
RRR:::::GGG::::::::::::::::::GGGGGGGG::#
RRRRR:::::::::::::::::::::::::GGGGG::::#
RRRRR::::::::=====:::::::::::::::::::::#
RRRR:::::::==============::::::::::::::#
RRRRR:::===================::::::::::::#
==============================:::::::::#
==================================:::::#
=======================================#
=======================================#
=======================================#
