#################      ################# 
#        ########      #################
#        ########      #################
#         #######      ################# 
#                                   #### 
#                                   #### 
#                                   #### 
#                                   #### 
#                                   #### 
#                                    ### 
#                                    
#                                      
#   
#  
#  
#  
#                                      # 
#                                      #  
#                                      #  
#                                      #  
#     ##                               #  
#   ##  #                   ####       #  
####     ###################    ##     #  
#                                 ##   #  
#                                   #### 
#                                      # 
#                                      # 
######################################## 
