########################################
########################################
############                     #######
###########                          ###
####                                  ##
##                                    ##
##                                    ##
##                                    ##
##                                    ##
##                                    ##
##                                     
##                                     
##                                     
##                                      
##                                     
##                                  
##                                    ##                                 
##                                    ##   
##                                    ##       
##                                    ##   
##                                    ## 
##                                   ###  
###                                ##### 
####                              ######      
#######                         ########
########################################   
########################################       
########################################
