########################################
########################################
#####################                 ##
##############                        ##
############                          ##
############                          ##
###########                           ##
#########                             ##
########                             ###
########                             ###   
                                     ###
                                     ###
                                     ###
                                     ###
                                     ###
                                     ###
####                                 ###
#####                                ###
######                               ###
######                               ###
#######                              ###
########                            ####
#########                         ######
##########                      ########
#################      #################
#################      #################
#################      #################
#################      #################
