#################      ################# 
#        ########      #################
#        ########      #################
#         #######      ################# 
#                                   #### 
#                                   #### 
#                                   #### 
#                                   #### 
#                                   #### 
#                                    ### 
#                                    
#                                      
#   
#  
#      
#
#:       :::         ::::::            # 
#:::::::::::::::::::::::::::::  ::     #  
#::::::::::::::::::::::::::::::::::    #  
#::::::::::::::::::::::::::::::::::::::#  
#:::====:::::::::::::::::::::::::::::::# 
#::=======:::::::::::::::::======::::::#  
#=================================:::::#  
#====================================::#  
#======================================# 
#======================================# 
#======================================# 
######################################## 
