########################################
########################               #
#####################                  #
##############                         #
############                           #
############                           #
###########                            #
#########                              #
########                             ###
########                             ###   
                                     ###
                                     ###
                                     ###
                                     ###
                                     ###
                                     ###
####                                 ###
#####                                ###
######                               ###
######                               ###
#######                              ###
########                            ####
#########                         ######
##########                      ########
#################      #################
#################      #################
#################      #################
#################      #################
