#################      ################# 
#GGGGGGGGGGG##            ##GGGGGGGGGGG#
#GGGGGGGGGGGG##          ##GGGGGGGGGGGG#
#GGGGGGGGGGGGG############GGGGGGGGGGGGG#
#GGGGGGGGGGGGGGGGGGGGGGGGGGGGGGGGGGGGGG#
#GGGGGGGGGGGGGGGGGGGGGGGGGGGGGGGGGGGGGG#
#GGGGGGGGGGGGGGGGGGGGGGGGGGGGGGGGGGGGGG#
#GGGGGGGGGGGGGGGGGGGGGGGGGGGGGGGGGGGGGG#
#GGGGGGGGGGGGGGGGGGGGGGGGGGGGGGGGGGGGGG#
#GGGGGGGGGGGGGGGGGGGGGGGGGGGGGGGGGGGGGG#
GGGGGGGGGGGGGGGGGGGGGGGGGGGGGGGGGGGGGGG# 
GGGGGGGGGGGGGGGGGGGGGGGGGGGGGGGGGGGGGGG#
GGGGGGGGGGGGGGGGGGGGGGGGGGGGGGGGGGGGGGG#
GGGGGGGGGGGGGGGGGGGGGGGGGGGGGGGGGGGGGGG#
GGGGGGGGGGGGGGGGGGGGGGGGGGGGGGGGGGGGGGG#
GGGGGGGGGGGGGGGGGGGGGGGGGGGGGGGGGGGGGGG#
GGGGGGGGGGGGGGGGGGGGGGGGGGGGGGGGGGGGGGG#
GGGGGGGGGGGGGGGGGGGGGGGGGGGGGGGGGGGGGGG#
::::::::GGG::::::::::::::::::GGGGGGGG::#
::::::::::::::::::::::::::::::GGGGG::::#
:::::::::::::=====:::::::::::::::::::::#
:::::::::::==============::::::::::::::#
::::::::===================::::::::::::#
==============================:::::::::#
==================================:::::#
=======================================#
=======================================#
=======================================#
