#################      #################
#################      #################
################        ################
######                     ############# 
#####                           ########
####                                ####
####                                ####
####                                ####
####                                  ## 
###                                   ##
                                      ##
                                      ##
                                      ##
                                      ##
                                      ##
                                      ##
####                                  ##
#####                                 ##
#####                                ###
#####                                ### 
#####                                ###
#####                               ####
######                             #####
#########                         ######
##########                     #########
###########                #############
#################      #################
#################      #################
