#################cccccc################# 
#GGGGGGGGGGG##cccccccccccc##GGGGGGGGGGGG
#GGGGGGGGGGGG##cccccccccc##GGGGGGGGGGGGG
#GGGGGGGGGGGGG############GGGGGGGGGGGGGG
#GGGGGGGGGGGGGGGGGGGGGGGGGGGGGGGGGGGGGGG
RRGGGGGGGGGGGGGGGGGGGGGGGGGGGGGGGGGGGGGG
RRRRGGGGGGGGGGGGGGGGGGGGGGGGGGGGGGGGGGGG
RRRRGGGGGGGGGGGGGGGGGGGGGGGGGGGGGGGGGGGG
RRRGGGGGGGGGGGGGGGGGGGGGGGGGGGGGGGGGGGGG
RRGGGGGGGGGGGGGGGGGGGGGGGGGGGGGGGGGGGGGG
RGGGGGGGGGGGGGGGGGGGGGGGGGGGGGGGGGGGGGGG 
GGGGGGGGGGGGGGGGGGGGGGGGGGGGGGGGGGGGGGGG
GGGGGGGGGGGGGGGGGGGGGGGGGGGGGGGGGGGGGGGG
GGGGGGGGGGGGGGGGGGGGGGGGGGGGGGGGGGGGGGGG 
GGGGGGGGGGGGGGGGGGGGGGGGGGGGGGGGGGGGGGGG
GGGGGGGGGGGGGGGGGGGGGGGGGGGGGGGGGGGGGGGG
GGGGGGGGGGGGGGGGGGGGGGGGGGGGGGGGGGGGGGGG
RRGGGGGGGGGGGGGGGGGGGGGGGGGGGGGGGGGGGGGG
RRR:::::GGG::::::::::::::::::GGGGGGGG:::
RRRRR:::::::::::::::::::::::::GGGGG:::::
RRRRR::::::::=====::::::::::::::::::::::
RRRR:::::::==============:::::::::::::::
RRRRR:::===================:::::::::::::
==============================::::::::::
==================================::::::
========================================
========================================
========================================12345669
