#################      ################# 
#        ########      #################
#        ########      #################
#         #######      ################# 
#                                   #### 
#                                   #### 
#                                   #### 
#                                   #### 
#                                   #### 
#                                    ### 
#                                    
#                                      
#   
#  
#      
#  
#                                      # 
#                                      #  
#                                      #  
#    ::::                              #  
#  ::####:                 ::::::      #  
#::###  ##:::::::::::::::::######:     #  
####     ###################    ##:::  #  
#                                 ###::#  
#                                   #### 
#                                      # 
#                                      # 
######################################## 
