#################      ################# 
#################                      #
#########       #######                #
####                  ######           #      
####                       ############# 
###                                    # 
##                                     # 
##                                     # 
##                                     # 
##                                     # 
                                       # 
                                       
    
   
   
   
#                                      #   
#                                      #   
#                                      #   
#                                      #   
#                                      #   
#                                      #   
#    #######                           #  
#  ###     ##########         ##########    
####                ###########        # 
#                                      # 
#                                      # 
######################################## 
