#################      ################# 
#        ########      #################
#        ########      #################
#         #######      ################# 
#                                   #### 
#                                   #### 
#                                   #### 
#                                   #### 
#                                   #### 
#                                    ### 
#                                    
#                                      
#   
#  
#      
#::::::::::           :::::::::::::::::
#:::::::::::         ::::::::::::::::::# 
#::::::::::::::::::::::::::::::::::::::#  
#::::::::::::::::::::::::::::::::::::::#  
#::::::::::::::::::::::::::::::::::::::#  
#:::####:::::::::::::::::::::::::::::::# 
#::###  ##:::::::::::::::::######::::::#  
####     ###################    ##:::::#  
#                                 ###::#  
#                                   #### 
#                                      # 
#                                      # 
######################################## 
