########################################
########################################
########################################
##############      ####################
############                        ####
############                        ####
###########                         ####
#########                           ####
########                            ####
########                            ####   
  
  
  
  

  
####                                  ##
#####                                 ##
######                                ##
######                                ##
#######                              ###
########                            ####
#########                         ######
##########                      ########
#################      #################
#################      #################
#################      #################
#################      #################




