#################      ################# 
#################                      #
#########       ###############        #
####                          ###      # 
####                            ######## 
###                                    # 
##                                     # 
##                                     # 
##                                     # 
##                                     # 
                                       # 
                                       
    
   
   
   
#                                      #   
#                                      #   
#                                      #   
#                                      #   
#                                      #   
#                                      #   
#    #######                           #  
#  ###     ##########         ##########    
####                ###########        # 
#                                      # 
#                                      # 
######################################## 
