#################GGGGGG################# 
#GGGGGGGG########GGGGGG#################
#GGGGGGGG########GGGGGG#################
#GGGGGGGGG#######GGGGGG################# 
#GGGGGGGGGGGGGGGGGGGGGGGGGGGGGGGGGGG#### 
#GGGGGGGGGGGGGGGGGGGGGGGGGGGGGGGGGGG#### 
#GGGGGGGGGGGGGGGGGGGGGGGGGGGGGGGGGGG#### 
#GGGGGGGGGGGGGGGGGGGGGGGGGGGGGGGGGGG#### 
#GGGGGGGGGGGGGGGGGGGGGGGGGGGGGGGGGGG#### 
#GGGGGGGGGGGGGGGGGGGGGGGGGGGGGGGGGGGG### 
#GGGGGGGGGGGGGGGGGGGGGGGGGGGGGGGGGGGGGGG
#GGGGGGGGGGGGGGGGGGGGGGGGGGGGGGGGGGGGGGG
#GGGGGGGGGGGGGGGGGGGGGGGGGGGGGGGGGGGGGGG
#GGGGGGGGGGGGGGGGGGGGGGGGGGGGGGGGGGGGGGG
#GGGGGGGGGGGGGGGGGGGGGGGGGGGGGGGGGGGGGGG
#GGGGGGGGGGGGGGGGGGGGGGGGGGGGGGGGGGGGGGG
#:GGGGGGG:::GGGGGGGGG::::::GGGGGGGGGGGG# 
#:::::::::::::::::::::::::::::GG::GGGGG#  
#::::::::::::::::::::::::::::::::::GGGG#  
#::::::::::::::::::::::::::::::::::::::#  
#:::====:::::::::::::::::::::::::::::::# 
#::=======:::::::::::::::::======::::::#  
#=================================:::::#  
#====================================::#  
#======================================# 
#======================================# 
#======================================# 
######################################## 
