########################################
########################################
########        #####               ####
###                                 ####
###                                  ###
####                                 ###
####                                 ###
####                                  ##
####                                  ## 
####                                  ##
####
####
####
###
###
###
####                                  ##
#####                                 ##
#####                                ###
#####                                ### 
#####                                ###
#####                                ###
######                               ###
#########                            ###
##########                          ####
###########                #############
#################      #################
#################      #################
