#################      ################# 
#################      #################
#########   #####      #################
####        #####      ################# 
####        #####    ###               # 
###         #########                  # 
##                                     # 
##                                     # 
##                                     # 
##                                     # 
#                                      # 
                                       
    
   
   
   
                                         
                                         
                                         
                                         
                                         
                                         
                                        
                                         
#                                      # 
#                                      # 
#                                      # 
######################################## 
