#################      ################# 
#        ########      #################
#        ########      #################
#         #######      ################# 
#                                   #### 
#                                   #### 
#                                   #### 
#                                   #### 
#                                   #### 
#                                    ### 
#                                    ### 
#                                      
#   
#  
#  
#  
#                                        
#                                        
#                                        
#                                        
#     ##                                 
#   ##  #                   ####         
####     ###################    ##       
#                                 ##     
#                                   #### 
#                                      # 
#                                      # 
######################################## 
